"aa" = (/turf/closed/mineral,/area/f13/caves)
"ab" = (/turf/closed/wall/f13/store{desc = "It's a wall made of solid concrete."; name = "concrete wall"},/area/f13/bar)
"ac" = (/obj/structure/closet/crate/engineering/electrical,/turf/open/floor/f13{dir = 9; icon_state = "yellowsiding"},/area/f13/bar)
"ad" = (/obj/machinery/power/apc{cell_type = 40000; dir = 1; name = "Bar APC"; pixel_y = 24},/obj/structure/cable{icon_state = "0-2"; d2 = 2},/turf/open/floor/f13{dir = 1; icon_state = "yellowsiding"},/area/f13/bar)
"ae" = (/turf/open/floor/f13{dir = 5; icon_state = "yellowsiding"},/area/f13/bar)
"af" = (/obj/structure/safe,/turf/open/floor/f13{icon_state = "floorsolid"},/area/f13/bar)
"ag" = (/obj/structure/sink/kitchen,/turf/closed/wall/f13/store{desc = "It's a wall made of solid concrete."; name = "concrete wall"},/area/f13/bar)
"ah" = (/obj/structure/table,/obj/item/weapon/reagent_containers/spray/cleaner{desc = "Agent Smith!-brand non-foaming cleaning agent!"; name = "cleaning agent"},/turf/open/floor/f13{icon_state = "floordirty"},/area/f13/bar)
"ai" = (/obj/structure/mopbucket,/turf/open/floor/f13{icon_state = "floorrusty"},/area/f13/bar)
"aj" = (/obj/structure/closet/cabinet,/obj/item/weapon/soap/deluxe,/obj/item/clothing/shoes/f13/tan,/obj/item/clothing/under/f13/petrochico,/obj/item/clothing/gloves/fingerless,/turf/open/floor/f13{icon_state = "floorrusty"},/area/f13/bar)
"ak" = (/obj/machinery/power/smes{charge = 5e+006},/obj/structure/cable{icon_state = "0-4"; d2 = 4},/turf/open/floor/f13{dir = 8; icon_state = "yellowsiding"},/area/f13/bar)
"al" = (/obj/structure/cable{d1 = 1; d2 = 8; icon_state = "1-8"; pixel_x = 0},/turf/open/floor/f13,/area/f13/bar)
"am" = (/obj/machinery/light/small/red{dir = 4},/turf/open/floor/f13{dir = 4; icon_state = "yellowsiding"},/area/f13/bar)
"an" = (/obj/structure/table/wood/classic,/obj/item/weapon/reagent_containers/food/drinks/drinkingglass{pixel_x = 2; pixel_y = 1},/obj/item/weapon/reagent_containers/food/drinks/drinkingglass,/obj/item/weapon/reagent_containers/food/drinks/drinkingglass{pixel_x = 3},/obj/item/weapon/reagent_containers/food/drinks/drinkingglass{pixel_x = 4; pixel_y = 3},/obj/item/weapon/reagent_containers/food/drinks/drinkingglass{pixel_y = 4},/obj/item/weapon/reagent_containers/food/drinks/drinkingglass,/turf/open/floor/f13/wood,/area/f13/bar)
"ao" = (/obj/structure/table/wood/classic,/obj/item/weapon/reagent_containers/food/drinks/shaker,/obj/item/clothing/shoes/laceup,/obj/item/clothing/under/lawyer/purpsuit,/obj/item/clothing/head/f13/purple,/turf/open/floor/f13/wood,/area/f13/bar)
"ap" = (/obj/structure/closet/cabinet,/obj/item/weapon/reagent_containers/food/drinks/bottle/sunset,/obj/item/weapon/reagent_containers/food/drinks/bottle/sunset,/obj/item/weapon/reagent_containers/food/drinks/bottle/sunset,/obj/item/weapon/reagent_containers/food/drinks/bottle/sunset,/obj/item/weapon/reagent_containers/food/drinks/bottle/sunset,/obj/item/weapon/reagent_containers/food/drinks/bottle/sunset,/obj/item/weapon/reagent_containers/food/drinks/bottle/sunset,/obj/item/weapon/reagent_containers/food/drinks/bottle/sunset,/obj/item/weapon/reagent_containers/food/drinks/bottle/sunset,/obj/item/weapon/gun/ballistic/shotgun/trail,/turf/open/floor/f13/wood,/area/f13/bar)
"aq" = (/turf/open/floor/f13/wood,/area/f13/bar)
"ar" = (/obj/structure/closet/crate/bin,/turf/open/floor/f13/wood,/area/f13/bar)
"as" = (/obj/structure/rack,/obj/item/weapon/mop,/turf/open/floor/f13{icon_state = "floorrusty"},/area/f13/bar)
"at" = (/turf/open/floor/f13{icon_state = "floordirty"},/area/f13/bar)
"au" = (/turf/open/floor/f13{icon_state = "floorrusty"},/area/f13/bar)
"av" = (/turf/open/floor/f13{dir = 9; icon_state = "yellowsiding"},/area/f13/bar)
"aw" = (/turf/open/floor/f13{dir = 1; icon_state = "yellowsiding"},/area/f13/bar)
"ax" = (/obj/machinery/power/terminal{icon_state = "term"; dir = 1},/obj/structure/cable{icon_state = "0-2"; d2 = 2},/turf/open/floor/f13{dir = 1; icon_state = "yellowsidingcorner"},/area/f13/bar)
"ay" = (/turf/open/floor/f13,/area/f13/bar)
"az" = (/obj/structure/simple_door/room,/turf/open/floor/f13{icon_state = "floordirtysolid"},/area/f13/bar)
"aA" = (/obj/structure/chair/wood/worn{dir = 1},/turf/open/floor/f13/wood,/area/f13/bar)
"aB" = (/obj/structure/closet/fridge,/obj/item/weapon/reagent_containers/food/drinks/ale,/obj/item/weapon/reagent_containers/food/drinks/bottle/cognac,/obj/item/weapon/reagent_containers/food/drinks/bottle/cream,/obj/item/weapon/reagent_containers/food/drinks/bottle/gin,/obj/item/weapon/reagent_containers/food/drinks/bottle/hcider,/obj/item/weapon/reagent_containers/food/drinks/bottle/kahlua,/obj/item/weapon/reagent_containers/food/drinks/bottle/orangejuice,/obj/item/weapon/reagent_containers/food/drinks/bottle/rum,/obj/item/weapon/reagent_containers/food/drinks/bottle/tomatojuice,/obj/item/weapon/reagent_containers/food/drinks/bottle/vermouth,/obj/item/weapon/reagent_containers/food/drinks/bottle/vodka,/obj/item/weapon/reagent_containers/food/drinks/bottle/whiskey,/obj/item/weapon/reagent_containers/food/drinks/bottle/wine,/turf/open/floor/f13/wood,/area/f13/bar)
"aC" = (/obj/structure/simple_door/brokenglass,/turf/open/floor/f13{icon_state = "floorrustysolid"},/area/f13/bar)
"aD" = (/obj/machinery/light/small/red{dir = 8},/turf/open/floor/f13{dir = 8; icon_state = "yellowsiding"},/area/f13/bar)
"aE" = (/obj/structure/cable{icon_state = "0-4"; d2 = 4},/turf/open/floor/f13,/area/f13/bar)
"aF" = (/obj/structure/cable{d1 = 4; d2 = 8; icon_state = "4-8"; pixel_y = 0},/turf/open/floor/f13,/area/f13/bar)
"aG" = (/obj/structure/cable{d1 = 4; d2 = 8; icon_state = "4-8"; pixel_y = 0},/turf/open/floor/f13{icon_state = "yellowsidingcorner"},/area/f13/bar)
"aH" = (/obj/structure/cable{d1 = 1; d2 = 8; icon_state = "1-8"; pixel_x = 0},/turf/open/floor/f13{icon_state = "yellowsiding"},/area/f13/bar)
"aI" = (/obj/structure/chair/stool,/turf/open/floor/f13{icon_state = "yellowsiding"},/area/f13/bar)
"aJ" = (/obj/structure/table,/turf/open/floor/f13{dir = 6; icon_state = "yellowsiding"},/area/f13/bar)
"aK" = (/obj/structure/closet/crate/freezer,/obj/item/weapon/reagent_containers/food/drinks/soda_cans/sodawater,/obj/item/weapon/reagent_containers/food/drinks/soda_cans/space_mountain_wind,/obj/item/weapon/reagent_containers/food/drinks/soda_cans/space_up,/obj/item/weapon/reagent_containers/food/drinks/soda_cans/starkist,/obj/item/weapon/reagent_containers/food/drinks/soda_cans/thirteenloko,/obj/item/weapon/reagent_containers/food/drinks/soda_cans/tonic,/turf/open/floor/f13/wood,/area/f13/bar)
"aL" = (/obj/machinery/light/small,/turf/open/floor/f13/wood,/area/f13/bar)
"aM" = (/obj/structure/simple_door/room,/turf/open/floor/f13/wood,/area/f13/bar)
"aN" = (/obj/machinery/light/small{dir = 1},/turf/open/floor/f13/wood,/area/f13/bar)
"aO" = (/turf/open/indestructible/ground/mountain,/area/f13/caves)
"aP" = (/turf/open/floor/f13{dir = 10; icon_state = "yellowsiding"},/area/f13/bar)
"aQ" = (/turf/open/floor/f13{icon_state = "yellowsiding"},/area/f13/bar)
"aR" = (/turf/open/floor/f13{dir = 6; icon_state = "yellowsiding"},/area/f13/bar)
"aS" = (/obj/structure/simple_door/interior,/turf/open/floor/f13/wood,/area/f13/bar)
"aT" = (/obj/structure/piano,/turf/open/floor/f13/wood,/area/f13/bar)
"aU" = (/obj/structure/chair/wood/worn{dir = 8},/turf/open/floor/f13/wood,/area/f13/bar)
"aV" = (/obj/machinery/vending/nukacolavend/full,/turf/open/floor/f13/wood,/area/f13/bar)
"aW" = (/obj/structure/closet/fridge/meat,/turf/open/floor/f13{icon_state = "bar"},/area/f13/bar)
"aX" = (/turf/open/floor/f13{icon_state = "bar"},/area/f13/bar)
"aY" = (/obj/machinery/light/sign{pixel_y = 32},/mob/living/carbon/monkey/special,/turf/open/floor/f13/wood,/area/f13/bar)
"aZ" = (/obj/structure/table/wood/bar,/obj/item/clothing/head/f13/gambler,/turf/open/floor/f13/wood,/area/f13/bar)
"ba" = (/obj/structure/window/fulltile/ruins{icon_state = "ruinswindowvertical"},/turf/open/floor/f13/wood,/area/f13/bar)
"bb" = (/obj/structure/closet/fridge/standard,/turf/open/floor/f13{icon_state = "bar"},/area/f13/bar)
"bc" = (/obj/structure/simple_door/glass,/turf/open/floor/f13{icon_state = "bar"},/area/f13/bar)
"bd" = (/obj/structure/table/wood/bar,/obj/item/weapon/reagent_containers/food/drinks/drinkingglass,/turf/open/floor/f13/wood,/area/f13/bar)
"be" = (/obj/structure/chair/wood/worn,/turf/open/floor/f13/wood,/area/f13/bar)
"bf" = (/obj/machinery/light/small{dir = 4},/turf/open/floor/f13/wood,/area/f13/bar)
"bg" = (/obj/structure/table/reinforced,/obj/item/weapon/kitchen/knife,/obj/item/weapon/kitchen/rollingpin,/turf/open/floor/f13{icon_state = "bar"},/area/f13/bar)
"bh" = (/obj/machinery/light/small{dir = 4},/turf/open/floor/f13{icon_state = "bar"},/area/f13/bar)
"bi" = (/obj/structure/table/wood/bar,/obj/machinery/light/small{dir = 8},/turf/open/floor/f13/wood,/area/f13/bar)
"bj" = (/obj/structure/table/wood/bar,/obj/item/weapon/reagent_containers/food/drinks/bottle/sunset,/turf/open/floor/f13/wood,/area/f13/bar)
"bk" = (/obj/structure/table/wood/bar,/turf/open/floor/f13/wood,/area/f13/bar)
"bl" = (/obj/structure/table/wood/bar,/obj/item/weapon/reagent_containers/glass/rag{pixel_x = 3; pixel_y = 4},/turf/open/floor/f13/wood,/area/f13/bar)
"bm" = (/obj/structure/chair/wood/worn{dir = 4},/turf/open/floor/f13/wood,/area/f13/bar)
"bn" = (/obj/structure/table/wood/classic,/obj/item/weapon/reagent_containers/food/drinks/bottle/sunset,/turf/open/floor/f13/wood,/area/f13/bar)
"bo" = (/obj/structure/table/reinforced,/obj/item/weapon/reagent_containers/food/condiment/enzyme,/obj/item/weapon/reagent_containers/glass/beaker/large,/turf/open/floor/f13{icon_state = "bar"},/area/f13/bar)
"bp" = (/obj/structure/chair/stool/bar,/turf/open/floor/f13/wood,/area/f13/bar)
"bq" = (/obj/structure/kitchenspike,/turf/open/floor/f13{icon_state = "bar"},/area/f13/bar)
"br" = (/obj/structure/table/reinforced,/obj/machinery/light/small{dir = 1},/turf/open/floor/f13{icon_state = "bar"},/area/f13/bar)
"bs" = (/obj/structure/table/reinforced,/obj/item/weapon/reagent_containers/food/condiment/saltshaker,/turf/open/floor/f13{icon_state = "bar"},/area/f13/bar)
"bt" = (/obj/structure/table/reinforced,/obj/item/weapon/reagent_containers/food/condiment/peppermill{pixel_x = 2; pixel_y = 3},/turf/open/floor/f13{icon_state = "bar"},/area/f13/bar)
"bu" = (/obj/structure/table/wood/classic,/obj/item/weapon/reagent_containers/food/condiment/saltshaker,/turf/open/floor/f13/wood,/area/f13/bar)
"bv" = (/obj/structure/table/wood/classic,/obj/item/weapon/reagent_containers/food/drinks/bottle/nukacola,/turf/open/floor/f13/wood,/area/f13/bar)
"bw" = (/obj/structure/table/wood/classic,/obj/item/weapon/reagent_containers/food/drinks/drinkingglass,/turf/open/floor/f13/wood,/area/f13/bar)
"bx" = (/obj/structure/simple_door/room,/turf/open/floor/f13{icon_state = "freezerfloor"},/area/f13/bar)
"by" = (/obj/machinery/light/small{dir = 8},/turf/open/floor/f13/wood,/area/f13/bar)
"bz" = (/turf/open/floor/f13{icon_state = "freezerfloor"},/area/f13/bar)
"bA" = (/obj/structure/closet/chefcloset,/turf/open/floor/f13{icon_state = "freezerfloor"},/area/f13/bar)
"bB" = (/obj/structure/disposalpipe/broken{dir = 4},/turf/open/indestructible/ground/mountain,/area/f13/caves)
"bC" = (/obj/structure/disposalpipe/segment{dir = 4},/turf/closed/mineral,/area/f13/caves)
"bD" = (/obj/structure/disposalpipe/segment{dir = 4},/turf/closed/wall/f13/store{desc = "It's a wall made of solid concrete."; name = "concrete wall"},/area/f13/bar)
"bE" = (/obj/structure/disposalpipe/trunk{dir = 8},/obj/machinery/disposal/deliveryChute{dir = 4},/turf/open/floor/f13{icon_state = "freezerfloor"},/area/f13/bar)
"bF" = (/obj/machinery/light/small/red{dir = 4},/turf/open/floor/f13{icon_state = "freezerfloor"},/area/f13/bar)
"bG" = (/obj/structure/chair/wood/fancy{dir = 4},/turf/open/floor/f13/wood,/area/f13/bar)
"bH" = (/obj/structure/chair/wood/fancy{dir = 8},/turf/open/floor/f13/wood,/area/f13/bar)
"bI" = (/obj/structure/table/wood/classic,/turf/open/floor/f13/wood,/area/f13/bar)
"bJ" = (/obj/structure/kitchenspike,/turf/open/floor/f13{icon_state = "freezerfloor"},/area/f13/bar)
"bK" = (/obj/structure/table/reinforced,/obj/item/weapon/kitchen/knife,/obj/item/weapon/kitchen/knife/butcher,/obj/item/weapon/machete,/turf/open/floor/f13{icon_state = "freezerfloor"},/area/f13/bar)
"bL" = (/obj/structure/closet/crate/freezer,/turf/open/floor/f13{icon_state = "freezerfloor"},/area/f13/bar)

(1,1,1) = {"
aaaaaaaaaaaaaaaaaaaaaaaaaaaaaaaaaaaaaaaaaaaaaaaaaaaaaaaaaaaa
aaaaaaaaaaaaaaaaaaaaaaaaaaaaaaaaaaaaaaaaaaaaaaaaaaaaaaaaaaaa
aaaaaaaaaaaaaaaaaaaaaaaaaaaaaaaaaaaaaaaaaaaaaaaaaaaaaaaaaaaa
aaaaaaaaaaaaaaaaaaaaaaaaaaaaaaaaaaaaaaaaaaaaaaaaaaaaaaaaaaaa
aaaaaaaaaaaaaaaaaaaaaaaaaaaaaaaaaaaaaaaaaaaaaaaaaaaaaaaaaaaa
aaaaaaaaaaaaaaaaaaaaaaaaaaaaaaaaaaaaaaaaaaaaaaaaaaaaaaaaaaaa
aaaaaaaaaaaaaaaaaaaaaaaaaaaaaaaaaaaaaaaaaaaaaaaaaaaaaaaaaaaa
aaaaaaaaaaaaaaaaaaaaaaaaaaaaaaaaaaaaaaaaaaaaaaaaaaaaaaaaaaaa
aaaaaaaaaaababababababaaaaaaaaaaabababababaaaaaaaaaaaaaaaaaa
aaaaaaaaaaabacadaeafababababagababahaiajabaaaaaaaaaaaaaaaaaa
aaabababababakalamababanaoapaqarabasatauabaaaaaaaaaaaaaaaaaa
aaabavawawawaxayayazaqaqaAaqaqaBababaCababababaaaaaaaaaaaaaa
aaabaDaEaFaGaHaIaJabaKaqaLaqaqaqaMaqaqaNaqarababaOaaaaaaaaaa
aaabaPaQaQaRababagababaSabababababaTaUaqaqaqaVabaOaOaaaaaaaa
aaababababababaWaXabaqaqaqaYaqaqaZaqaqaqaqaqaqbaaOaOaOaaaaaa
aaaaaaaaaaabbbaXaXbcaqaqaqaqaqaqbdaqaqbeaqaqbfabaOaOaOaOaaaa
aaaaaaaaaaabbgaXbhabbibjbkbdblbkbkaqbmbnaUaqaqbaaOaOaOaOaOaO
aaaaaaaaaaabboaXaXabbpbpbpbpbpbpbpaqaqaAaqaqbfabaOaOaOaOaOaO
aaaaaaaaaaabbqaXaXbraqaqaqaqaqaqaqaqaqaqaqaqaqaSaOaOaOaOaOaO
aaaaaaaaaaababaXaXbsaqaqbeaqaqaqbeaqaqaqbeaqaqabaOaOaOaOaOaO
aaaaaaaaaaaaabaXaXbtaqbmbuaUaqbmbvaUaqbmbwaUababaOaOaaaOaOaO
aaaaaaaaaaaaabbxababbyaqaAaqaqaqaAaqbfababababaaaaaaaaaaaOaO
aOaaaaaaaaababbzbAagabaqaqaqaLaqaqaqababaaaaaaaaaaaaaaaaaaaa
aObBbCbCbCbDbEbzbzbFabbGbvbHabbGbIbHabaaaaaaaaaaaaaaaaaaaaaa
aOaaaaaaaaababbJbKbLabababababababababaaaaaaaaaaaaaaaaaaaaaa
aaaaaaaaaaaaabababababaaaaaaaaaaaaaaaaaaaaaaaaaaaaaaaaaaaaaa
aaaaaaaaaaaaaaaaaaaaaaaaaaaaaaaaaaaaaaaaaaaaaaaaaaaaaaaaaaaa
aaaaaaaaaaaaaaaaaaaaaaaaaaaaaaaaaaaaaaaaaaaaaaaaaaaaaaaaaaaa
aaaaaaaaaaaaaaaaaaaaaaaaaaaaaaaaaaaaaaaaaaaaaaaaaaaaaaaaaaaa
aaaaaaaaaaaaaaaaaaaaaaaaaaaaaaaaaaaaaaaaaaaaaaaaaaaaaaaaaaaa
"}
