"a" = (/turf/closed/mineral,/area/f13/wasteland)
"b" = (/turf/open/indestructible/ground/mountain,/area/f13/wasteland)
"c" = (/turf/open/indestructible/ground/desert,/area/f13/wasteland)
"d" = (/obj/structure/barrel/dangerous,/turf/open/indestructible/ground/mountain,/area/f13/wasteland)
"e" = (/obj/effect/decal/goo,/turf/open/indestructible/ground/mountain,/area/f13/wasteland)
"f" = (/obj/structure/barrel,/turf/open/indestructible/ground/mountain,/area/f13/wasteland)

(1,1,1) = {"
aaaaaaaaaaaaaaaaaaaabbbaaaaaaaaaaaaaaaaaaaaaaaaaaa
aaaaaaaaaacaaaaaaaaaabbaaaaaaaaaaaaaaaaaaaaaaaaaaa
aaaaaaccccccaaaaaaadebbaaaaaaaaaaaaaaaaaaaaaaaaaaa
aaaacccccccccaaaaafebbbbaaaaaaaaaaaaaaaaaaaaaaaaaa
aaaccccccccccaaaaaaabbbbbaaaaaaaaaaaaaaaaaaaaaaaaa
aaccccccccccccaaaaaaaabbaaaaaaaaaaaaaaaaaaaaaaaaaa
aacccccccccccccaaaaaaaabbaaaaaaaaaaaaaaaaaaaaaaaaa
acccccccccccccccacaaaaaabbaaaaaaaaaaaaaaaaaaaaaaaa
aacccccccccccccccccaaaaaaccaaaaaaaaaaaaaaaaaaaaaaa
aaccccccccccccccccccccaaacccaaaaaaaaaaaaaaaaaaaaaa
aaaccccccccccccccccccccccccccaaaaaaaaaaaaaaaaaaaaa
aaaccccccccccccccccccccccccccccccaaaaaaaaaaaaaaaaa
aaaacccccccccccccccccccccccccccccccccaaaaaaaaaacaa
aaaacccccccccccccccccccccccccccccccccccaaaccaacccc
aaaacccccccccccccccccccccccccccccccccccccccccccccc
aaaaaccccccccccccccccccccccccccccccccccccccccccccc
aaaaaccccccccccccccccccccccccccccccccccccccccccccc
aaaacccccccccccccccccccccccccccccccccccccccccccccc
aaaacccccccccccccccccccccccccccccccccccccccccccccc
aaaaaccccccccccccccccccccccccccccccccccccccccccccc
aaaaaacccccccccccccccccccccccccccccccccccccccccccc
aaaaaccccccccccccccccccccccccccccccccccccccccccccc
aaaaaccccccccccccccccccccccccccccccccccccccccccccc
aaaacccccccccccccccccccccccccccccccccccccccccccccc
aaaacccccccccccccccccccccccccccccccccccccccccccccc
aaaaaccccccccccccccccccccccccccccccccccccccccccccc
aaaacccccccccccccccccccccccccccccccccccccccccccccc
aaaccccccccccccccccccccccccccccccccccccccccccccccc
aaaccccccccccccccccccccccccccccccccccccccccccccccc
aaaccccccccccccccccccccccccccccccccccccccccccccccc
aaaacccccccccccccccccccccccccccccccccccccccccccccc
aaaacccccccccccccccccccccccccccccccccccccccccccccc
aaaaaccccccccccccccccccccccccccccccccccccccccccccc
aaaacccccccccccccccccccccccccccccccccccccccccccccc
aaaaaccccccccccccccccccccccccccccccccccccccccccccc
aaaaaccccccccccccccccccccccccccccccccccccccccccccc
aaaacccccccccccccccccccccccccccccccccccccccccccccc
aaaacccccccccccccccccccccccccccccccccccccccccccccc
aaaaaccccccccccccccccccccccccccccccccccccccccccccc
aaaacccccccccccccccccccccccccccccccccccccccccccccc
aaaacccccccccccccccccccccccccccccccccccccccccccccc
aaaaaccccccccccccccccccccccccccccccccccccccccccccc
aaaaaacccccccccccccccccccccccccccccccccccccccccccc
aaaaaaaccccccccccccccccccccccccccccccccccccccccccc
aaaaaacccccccccccccccccccccccccccccccccccccccccccc
aaaaaccccccccccccccccccccccccccccccccccccccccccccc
aaaaaccccccccccccccccccccccccccccccccccccccccccccc
aaaacccccccccccccccccccccccccccccccccccccccccccccc
aaaacccccccccccccccccccccccccccccccccccccccccccccc
aaaacccccccccccccccccccccccccccccccccccccccccccccc
"}
