"aa" = (/turf/open/indestructible/ground/desert,/area/f13/wasteland)
"ab" = (/turf/open/floor/f13/wood,/area/f13/wasteland)
"ac" = (/turf/closed/wall/f13/wood/house/broken,/area/f13/wasteland)
"ad" = (/turf/open/indestructible/ground/sidewalk{dir = 8; icon_state = "outerpavementcorner"},/area/f13/wasteland)
"ae" = (/turf/open/indestructible/ground/sidewalk{icon_state = "outermaincornerouter"},/area/f13/wasteland)
"af" = (/turf/open/indestructible/ground/sidewalk{dir = 8; icon_state = "outermaincornerouter"},/area/f13/wasteland)
"ag" = (/obj/structure/flora/tree/wasteland,/turf/open/indestructible/ground/desert,/area/f13/wasteland)
"ah" = (/turf/open/indestructible/ground/sidewalk{dir = 2; icon_state = "outerpavementcorner"},/area/f13/wasteland)
"ai" = (/obj/item/weapon/bikehorn,/turf/open/floor/f13/wood,/area/f13/wasteland)
"aj" = (/turf/open/indestructible/ground/sidewalk{dir = 8; icon_state = "outerpavement"},/area/f13/wasteland)
"ak" = (/turf/open/indestructible/ground/sidewalk{dir = 4; icon_state = "outermaincornerouter"},/area/f13/wasteland)
"al" = (/turf/open/indestructible/ground/sidewalk{dir = 1; icon_state = "outermaincornerouter"},/area/f13/wasteland)
"am" = (/turf/open/indestructible/ground/sidewalk{dir = 2; icon_state = "outerpavement"},/area/f13/wasteland)
"an" = (/turf/open/indestructible/ground/sidewalk{dir = 6; icon_state = "outerpavement"},/area/f13/wasteland)
"ao" = (/turf/closed/wall/f13/wood/house,/area/f13/wasteland)
"ap" = (/obj/structure/table/wood/settler,/turf/open/floor/f13/wood,/area/f13/wasteland)
"aq" = (/turf/open/indestructible/ground/sidewalk{dir = 10; icon_state = "outerpavement"},/area/f13/wasteland)
"ar" = (/turf/open/indestructible/ground/sidewalk{dir = 4; icon_state = "outerpavement"},/area/f13/wasteland)
"as" = (/turf/closed/wall/f13/supermart{desc = "Remove kebab."; name = "kebab outpost wall"},/area/f13/secret)
"at" = (/turf/closed/wall/f13/supermart{desc = "Remove kebab."; icon_state = "storeprewindowleft"; name = "kebab outpost wall"},/area/f13/secret)
"au" = (/obj/structure/window/fulltile/store{icon_state = "storewindowleft"},/turf/open/floor/f13{icon_state = "floordirtysolid"},/area/f13/secret)
"av" = (/obj/structure/window/fulltile/store,/turf/open/floor/f13{icon_state = "floordirtysolid"},/area/f13/secret)
"aw" = (/obj/structure/window/fulltile/store{icon_state = "storewindowright"},/turf/open/floor/f13{icon_state = "floordirtysolid"},/area/f13/secret)
"ax" = (/turf/closed/wall/f13/supermart{desc = "Remove kebab."; icon_state = "storeprewindowright"; name = "kebab outpost wall"},/area/f13/secret)
"ay" = (/turf/closed/wall/f13/wood/house,/area/f13/building)
"az" = (/obj/structure/simple_door/brokenglass,/obj/structure/decoration/rag,/turf/open/floor/f13/wood,/area/f13/building)
"aA" = (/turf/closed/wall/f13/supermart{desc = "Remove kebab."; icon_state = "storeprewindowtop"; name = "kebab outpost wall"},/area/f13/secret)
"aB" = (/obj/machinery/light{dir = 1},/obj/structure/closet/cabinet,/obj/item/weapon/reagent_containers/food/drinks/bottle/nukacola,/obj/item/weapon/reagent_containers/food/drinks/bottle/nukacola,/obj/item/weapon/reagent_containers/food/drinks/bottle/nukacola,/obj/item/weapon/reagent_containers/food/drinks/bottle/nukacola,/obj/item/weapon/reagent_containers/food/drinks/bottle/sunset,/obj/item/weapon/reagent_containers/food/drinks/bottle/sunset,/obj/item/weapon/reagent_containers/food/drinks/bottle/sunset,/obj/item/weapon/reagent_containers/food/drinks/bottle/sunset,/obj/item/weapon/reagent_containers/food/drinks/bottle/sunset,/obj/item/weapon/reagent_containers/food/drinks/bottle/sunset,/obj/item/weapon/reagent_containers/food/drinks/bottle/sunset,/obj/item/weapon/reagent_containers/food/drinks/bottle/whiskey,/obj/item/weapon/reagent_containers/food/drinks/bottle/vodka,/obj/item/weapon/reagent_containers/food/drinks/bottle/rum,/obj/item/weapon/storage/box/drinkingglasses,/obj/item/weapon/reagent_containers/food/snacks/f13/mechanic,/obj/item/weapon/reagent_containers/food/snacks/f13/mechanic,/turf/open/floor/f13{icon_state = "floorrusty"},/area/f13/secret)
"aC" = (/turf/open/floor/f13{icon_state = "floorrusty"},/area/f13/secret)
"aD" = (/obj/machinery/light{dir = 1},/obj/structure/closet/crate/bin,/turf/open/floor/f13{icon_state = "floorrusty"},/area/f13/secret)
"aE" = (/obj/structure/mopbucket,/turf/open/floor/f13{icon_state = "bluedirtychess2"},/area/f13/secret)
"aF" = (/obj/machinery/light/small{dir = 1},/obj/item/weapon/mop,/turf/open/floor/f13{icon_state = "bluerustychess2"},/area/f13/secret)
"aG" = (/obj/structure/toilet,/turf/open/floor/f13{icon_state = "bluedirtychess2"},/area/f13/secret)
"aH" = (/obj/structure/bookcase/random/fiction,/turf/open/floor/f13/wood,/area/f13/building)
"aI" = (/obj/structure/table/wood/settler,/turf/open/floor/f13/wood,/area/f13/building)
"aJ" = (/obj/structure/closet/cabinet,/obj/item/clothing/shoes/f13/swimfins,/obj/item/clothing/under/f13/settler,/obj/item/weapon/reagent_containers/food/snacks/f13/porknbeans,/turf/open/floor/f13/wood,/area/f13/building)
"aK" = (/turf/open/floor/f13/wood,/area/f13/building)
"aL" = (/obj/machinery/light/small{dir = 1},/turf/open/floor/f13/wood,/area/f13/building)
"aM" = (/obj/structure/decoration/clock/old/active{pixel_y = 32},/turf/open/floor/f13/wood,/area/f13/building)
"aN" = (/obj/structure/table,/turf/open/floor/f13/wood,/area/f13/building)
"aO" = (/obj/structure/window/fulltile/store{icon_state = "storewindowtop"},/turf/open/floor/f13{icon_state = "floordirtysolid"},/area/f13/secret)
"aP" = (/turf/open/floor/f13{icon_state = "floordirty"},/area/f13/secret)
"aQ" = (/obj/structure/table/wood/bar,/turf/open/floor/f13{icon_state = "floorrusty"},/area/f13/secret)
"aR" = (/obj/structure/simple_door/room,/turf/open/floor/f13{icon_state = "bluedirtychess2"},/area/f13/secret)
"aS" = (/turf/open/floor/f13{icon_state = "bluedirtychess2"},/area/f13/secret)
"aT" = (/obj/item/trash/deadmouse,/turf/open/floor/f13{icon_state = "bluerustychess2"},/area/f13/secret)
"aU" = (/obj/structure/window/fulltile/store{icon_state = "storewindowvertical"},/turf/open/floor/f13{icon_state = "floordirtysolid"},/area/f13/secret)
"aV" = (/obj/structure/table/wood/bar,/turf/open/floor/f13{icon_state = "floordirty"},/area/f13/secret)
"aW" = (/obj/structure/table/wood/bar,/obj/item/weapon/reagent_containers/glass/rag{pixel_y = 7},/turf/open/floor/f13{icon_state = "floordirty"},/area/f13/secret)
"aX" = (/obj/structure/table/wood/bar,/obj/item/weapon/reagent_containers/food/drinks/bottle/nukacola{pixel_y = 5},/turf/open/floor/f13{icon_state = "floordirty"},/area/f13/secret)
"aY" = (/obj/structure/table,/obj/item/weapon/storage/box/lights/mixed,/turf/open/floor/f13{icon_state = "bluerustychess2"},/area/f13/secret)
"aZ" = (/obj/structure/sink{dir = 4; pixel_x = 14; pixel_y = 5},/obj/structure/mirror{pixel_x = 28},/turf/open/floor/f13{icon_state = "bluedirtychess2"},/area/f13/secret)
"ba" = (/obj/structure/chair/comfy/brown{dir = 4},/turf/open/floor/f13/wood,/area/f13/building)
"bb" = (/obj/structure/easel,/turf/open/floor/f13/wood,/area/f13/building)
"bc" = (/obj/structure/chair/wood{dir = 4},/turf/open/floor/f13/wood,/area/f13/building)
"bd" = (/obj/structure/chair/wood{dir = 8},/turf/open/floor/f13/wood,/area/f13/building)
"be" = (/obj/structure/window/fulltile/store{icon_state = "storewindowbottom"},/turf/open/floor/f13{icon_state = "floordirtysolid"},/area/f13/secret)
"bf" = (/obj/structure/chair/stool/bar,/turf/open/floor/f13{icon_state = "floorrusty"},/area/f13/secret)
"bg" = (/obj/structure/chair/stool/bar,/turf/open/floor/f13{icon_state = "floordirty"},/area/f13/secret)
"bh" = (/obj/structure/table/wood/settler,/obj/item/weapon/book/manual/random{pixel_y = 2},/turf/open/floor/f13/wood,/area/f13/building)
"bi" = (/obj/structure/table/wood/settler,/obj/item/trash/candle{pixel_y = 4},/turf/open/floor/f13/wood,/area/f13/building)
"bj" = (/turf/closed/wall/f13/supermart{desc = "Remove kebab."; icon_state = "storeprewindowbottom"; name = "kebab outpost wall"},/area/f13/secret)
"bk" = (/obj/machinery/light{dir = 8},/turf/open/floor/f13{icon_state = "floorrusty"},/area/f13/secret)
"bl" = (/obj/machinery/light{dir = 4},/turf/open/floor/f13{icon_state = "floorrusty"},/area/f13/secret)
"bm" = (/obj/structure/rack,/turf/open/floor/f13{icon_state = "floorrusty"},/area/f13/secret)
"bn" = (/obj/structure/closet/cabinet,/obj/item/clothing/shoes/laceup,/obj/item/clothing/under/f13/bartenderalt,/turf/open/floor/f13{icon_state = "floordirty"},/area/f13/secret)
"bo" = (/obj/machinery/light/small,/turf/open/floor/f13/wood,/area/f13/building)
"bp" = (/obj/structure/fence,/turf/open/indestructible/ground/sidewalk{dir = 8; icon_state = "outerpavement"},/area/f13/wasteland)
"bq" = (/obj/structure/fence/door,/turf/open/indestructible/ground/desert,/area/f13/wasteland)
"br" = (/obj/structure/fence,/turf/open/indestructible/ground/sidewalk{dir = 4; icon_state = "outerpavement"},/area/f13/wasteland)
"bs" = (/obj/structure/piano/pristine,/turf/open/floor/f13{icon_state = "floorrusty"},/area/f13/secret)
"bt" = (/obj/structure/chair/wood/modern{dir = 8},/turf/open/floor/f13{icon_state = "floordirty"},/area/f13/secret)
"bu" = (/obj/item/trash/tray,/turf/open/floor/f13{icon_state = "floorrusty"},/area/f13/secret)
"bv" = (/obj/structure/simple_door/glass,/turf/open/floor/f13{icon_state = "floordirty"},/area/f13/secret)
"bw" = (/obj/machinery/light/small{dir = 4},/turf/open/floor/f13{icon_state = "floordirty"},/area/f13/secret)
"bx" = (/obj/structure/window/fulltile/house/broken,/obj/structure/decoration/rag,/turf/open/floor/f13/wood,/area/f13/building)
"by" = (/obj/structure/simple_door/house,/turf/open/floor/f13/wood,/area/f13/building)
"bz" = (/obj/structure/window/fulltile/house,/turf/open/floor/f13/wood,/area/f13/building)
"bA" = (/obj/structure/chair/comfy/brown,/turf/open/floor/f13{icon_state = "floorrusty"},/area/f13/secret)
"bB" = (/obj/structure/table/wood,/obj/item/clothing/suit/armor/f13/kit,/turf/open/floor/f13{icon_state = "floorrusty"},/area/f13/secret)
"bC" = (/obj/structure/table/wood,/obj/item/weapon/book/manual/barman_recipes{pixel_y = 3},/turf/open/floor/f13{icon_state = "floorrusty"},/area/f13/secret)
"bD" = (/turf/open/indestructible/ground/sidewalk{dir = 4; icon_state = "outerpavementcorner"},/area/f13/wasteland)
"bE" = (/turf/open/indestructible/ground/sidewalk{dir = 1; icon_state = "outerpavement"},/area/f13/wasteland)
"bF" = (/turf/open/indestructible/ground/sidewalk{dir = 5; icon_state = "outerpavement"},/area/f13/wasteland)
"bG" = (/turf/open/indestructible/ground/sidewalk,/area/f13/wasteland)
"bH" = (/turf/open/indestructible/ground/sidewalk{dir = 9; icon_state = "outerpavement"},/area/f13/wasteland)
"bI" = (/turf/open/indestructible/ground/sidewalk{dir = 1; icon_state = "outerpavementcorner"},/area/f13/wasteland)
"bJ" = (/obj/machinery/light{dir = 8},/obj/structure/table/wood,/turf/open/floor/f13{icon_state = "floorrusty"},/area/f13/secret)
"bK" = (/obj/structure/table/wood,/obj/item/weapon/reagent_containers/food/snacks/kebab/tail{name = "lizard kebab"; pixel_y = 5},/turf/open/floor/f13{icon_state = "floordirty"},/area/f13/secret)
"bL" = (/obj/machinery/light{dir = 4},/obj/structure/table/wood,/obj/item/weapon/reagent_containers/food/drinks/bottle/sunset{pixel_y = 4},/turf/open/floor/f13{icon_state = "floorrusty"},/area/f13/secret)
"bM" = (/obj/machinery/light/small{dir = 4},/turf/open/floor/f13{icon_state = "floorrusty"},/area/f13/secret)
"bN" = (/obj/structure/chair/comfy/brown{dir = 1},/turf/open/floor/f13{icon_state = "floorrusty"},/area/f13/secret)
"bO" = (/obj/structure/chair/wood/modern{dir = 1},/turf/open/floor/f13{icon_state = "floorrusty"},/area/f13/secret)
"bP" = (/obj/structure/bed,/obj/item/weapon/bedsheet/red,/turf/open/floor/f13{icon_state = "floordirty"},/area/f13/secret)
"bQ" = (/obj/structure/table/wood,/obj/item/device/harmonica{pixel_y = 4},/turf/open/floor/f13{icon_state = "floordirty"},/area/f13/secret)
"bR" = (/obj/structure/bed,/obj/item/weapon/bedsheet/yellow,/turf/open/floor/f13{icon_state = "floordirty"},/area/f13/secret)
"bS" = (/obj/structure/simple_door/room,/turf/open/floor/f13{icon_state = "floorrustysolid"},/area/f13/secret)
"bT" = (/turf/open/indestructible/ground/sidewalk{icon_state = "tinycornerhorizontal"},/area/f13/wasteland)
"bU" = (/turf/open/indestructible/ground/sidewalk{icon_state = "horizontaltopbordertop2left"},/area/f13/wasteland)
"bV" = (/turf/open/indestructible/ground/sidewalk{icon_state = "horizontaltopbordertop2"},/area/f13/wasteland)
"bW" = (/turf/open/indestructible/ground/sidewalk{icon_state = "horizontaltopbordertop3"},/area/f13/wasteland)
"bX" = (/turf/open/indestructible/ground/sidewalk{icon_state = "horizontaltopbordertop2right"},/area/f13/wasteland)
"bY" = (/turf/open/indestructible/ground/sidewalk{icon_state = "horizontaltopbordertop0"},/area/f13/wasteland)
"bZ" = (/turf/open/indestructible/ground/sidewalk{icon_state = "horizontaltopbordertop1"},/area/f13/wasteland)
"ca" = (/turf/open/indestructible/ground/sidewalk{dir = 8; icon_state = "tinycornerhorizontal"},/area/f13/wasteland)
"cb" = (/obj/machinery/light/small/red{dir = 4},/turf/open/indestructible/ground/sidewalk,/area/f13/wasteland)
"cc" = (/obj/machinery/vending/nukacolavend,/turf/open/floor/f13/wood,/area/f13/secret)
"cd" = (/obj/structure/decoration/sign{desc = "Remove kebab."; icon_state = "vault_kebab"; name = "kebab sign"; pixel_x = -10; pixel_y = 28},/turf/open/floor/f13/wood,/area/f13/secret)
"ce" = (/turf/open/floor/f13/wood,/area/f13/secret)
"cf" = (/obj/machinery/light/small{dir = 1},/turf/open/floor/f13/wood,/area/f13/secret)
"cg" = (/obj/structure/filingcabinet/chestdrawer,/turf/open/floor/f13/wood,/area/f13/secret)
"ch" = (/obj/machinery/light/small/red{dir = 8},/turf/open/indestructible/ground/sidewalk{dir = 8; icon_state = "outerpavement"},/area/f13/wasteland)
"ci" = (/turf/open/indestructible/ground/sidewalk{icon_state = "tinycornervertical"},/area/f13/wasteland)
"cj" = (/turf/open/indestructible/ground/road{dir = 1; icon_state = "innerturn"},/area/f13/wasteland)
"ck" = (/turf/open/indestructible/ground/road{icon_state = "horizontaltopborderbottom1"},/area/f13/wasteland)
"cl" = (/turf/open/indestructible/ground/road{icon_state = "horizontaltopborderbottom2"},/area/f13/wasteland)
"cm" = (/obj/vehicle/fuel/motorcycle/rusty{dir = 4},/turf/open/indestructible/ground/road{icon_state = "horizontaltopborderbottom0"},/area/f13/wasteland)
"cn" = (/turf/open/indestructible/ground/road{icon_state = "horizontaltopborderbottom0"},/area/f13/wasteland)
"co" = (/turf/open/indestructible/ground/road{dir = 4; icon_state = "innerturn"},/area/f13/wasteland)
"cp" = (/turf/open/indestructible/ground/sidewalk{dir = 8; icon_state = "tinycornervertical"},/area/f13/wasteland)
"cq" = (/obj/structure/table/wood,/turf/open/floor/f13/wood,/area/f13/secret)
"cr" = (/obj/structure/table/wood,/obj/item/weapon/phone,/turf/open/floor/f13/wood,/area/f13/secret)
"cs" = (/turf/open/indestructible/ground/sidewalk{icon_state = "verticalleftborderleft1"},/area/f13/wasteland)
"ct" = (/turf/open/indestructible/ground/road,/area/f13/wasteland)
"cu" = (/turf/open/indestructible/ground/road{icon_state = "verticalinnermain1"},/area/f13/wasteland)
"cv" = (/turf/open/indestructible/ground/sidewalk{icon_state = "verticalrightborderright0"},/area/f13/wasteland)
"cw" = (/obj/structure/simple_door/metal/store,/turf/open/floor/f13/wood,/area/f13/secret)
"cx" = (/obj/structure/table/wood,/obj/item/toy/redbutton,/turf/open/floor/f13/wood,/area/f13/secret)
"cy" = (/obj/structure/chair/wood/worn{dir = 8},/turf/open/floor/f13/wood,/area/f13/secret)
"cz" = (/obj/structure/decoration/hatch{dir = 8; icon_state = "hatchbroken"},/turf/open/indestructible/ground/road{icon_state = "verticalleftborderright0"},/area/f13/wasteland)
"cA" = (/turf/open/indestructible/ground/road{icon_state = "verticalinnermain0"},/area/f13/wasteland)
"cB" = (/turf/open/indestructible/ground/road{icon_state = "hole"},/area/f13/wasteland)
"cC" = (/obj/structure/decoration/hatch{dir = 4},/turf/open/indestructible/ground/road{icon_state = "verticalrightborderleft1"},/area/f13/wasteland)
"cD" = (/obj/structure/chair/stool,/turf/open/floor/f13/wood,/area/f13/secret)
"cE" = (/turf/open/indestructible/ground/sidewalk{icon_state = "verticalleftborderleft0"},/area/f13/wasteland)
"cF" = (/turf/open/indestructible/ground/road{icon_state = "verticalleftborderright0"},/area/f13/wasteland)
"cG" = (/turf/open/indestructible/ground/road{icon_state = "verticalinnermain2"},/area/f13/wasteland)
"cH" = (/turf/open/indestructible/ground/road{icon_state = "innermaincornerinner"},/area/f13/wasteland)
"cI" = (/turf/open/indestructible/ground/road{dir = 8; icon_state = "innermaincornerinner"},/area/f13/wasteland)
"cJ" = (/turf/open/indestructible/ground/road{icon_state = "verticalrightborderleft0"},/area/f13/wasteland)
"cK" = (/turf/open/indestructible/ground/sidewalk{icon_state = "verticalrightborderright1"},/area/f13/wasteland)
"cL" = (/obj/structure/closet/crate/bin,/turf/open/floor/f13/wood,/area/f13/secret)
"cM" = (/obj/machinery/light/small,/turf/open/floor/f13/wood,/area/f13/secret)
"cN" = (/obj/structure/table,/obj/item/clothing/head/helmet/f13/eyebot,/turf/open/floor/f13/wood,/area/f13/secret)
"cO" = (/turf/open/indestructible/ground/road{icon_state = "verticalinnermainbottom"},/area/f13/wasteland)
"cP" = (/turf/open/indestructible/ground/road{dir = 1; icon_state = "innermaincornerouter"},/area/f13/wasteland)
"cQ" = (/turf/open/indestructible/ground/road{dir = 4; icon_state = "innermaincornerouter"},/area/f13/wasteland)
"cR" = (/obj/machinery/light/street{dir = 1; pixel_x = -32},/turf/open/indestructible/ground/sidewalk{dir = 8; icon_state = "outerpavement"},/area/f13/wasteland)
"cS" = (/turf/open/indestructible/ground/road{dir = 4; icon_state = "innermaincornerinner"},/area/f13/wasteland)
"cT" = (/turf/open/indestructible/ground/road{dir = 8; icon_state = "innermaincornerouter"},/area/f13/wasteland)
"cU" = (/turf/open/indestructible/ground/road{icon_state = "horizontalinnermainleft"},/area/f13/wasteland)
"cV" = (/obj/structure/table/wood/classic,/obj/item/weapon/storage/pill_bottle/dice,/turf/open/floor/f13{icon_state = "floordirty"},/area/f13/secret)
"cW" = (/obj/structure/bookcase/random/fiction,/turf/open/floor/f13{icon_state = "floordirty"},/area/f13/secret)
"cX" = (/obj/structure/bookcase/manuals/medical,/turf/open/floor/f13{icon_state = "floorrusty"},/area/f13/secret)
"cY" = (/obj/structure/rack,/turf/open/floor/f13{icon_state = "floordirty"},/area/f13/secret)
"cZ" = (/obj/structure/mirror{pixel_y = 26},/obj/structure/dresser,/turf/open/floor/f13{icon_state = "floorrusty"},/area/f13/secret)
"da" = (/obj/structure/bed,/obj/item/weapon/bedsheet/brown,/turf/open/floor/f13{icon_state = "floordirty"},/area/f13/secret)
"db" = (/obj/structure/table/wood/classic,/obj/item/weapon/holodisk/musicbox,/turf/open/floor/f13{icon_state = "floordirty"},/area/f13/secret)
"dc" = (/obj/structure/closet/cabinet,/obj/item/weapon/lipstick/black,/obj/item/weapon/reagent_containers/food/drinks/bottle/cognac,/obj/item/clothing/shoes/f13/diesel,/obj/item/clothing/under/female/blacktango,/obj/item/clothing/under/female/plaid_skirt,/obj/item/clothing/under/f13/female/merccharm,/turf/open/floor/f13{icon_state = "floorrusty"},/area/f13/secret)
"dd" = (/turf/open/indestructible/ground/road{dir = 6; icon_state = "innermaincornerouter"},/area/f13/wasteland)
"de" = (/turf/open/indestructible/ground/road{dir = 1; icon_state = "innermaincornerinner"},/area/f13/wasteland)
"df" = (/turf/open/indestructible/ground/road{icon_state = "verticalrightborderleft1"},/area/f13/wasteland)
"dg" = (/obj/machinery/light{dir = 4},/turf/open/floor/f13{icon_state = "floordirty"},/area/f13/secret)
"dh" = (/turf/open/indestructible/ground/sidewalk{dir = 4; icon_state = "outerbordercorner"},/area/f13/wasteland)
"di" = (/turf/open/indestructible/ground/sidewalk{dir = 4; icon_state = "outerturn"},/area/f13/wasteland)
"dj" = (/turf/open/indestructible/ground/sidewalk{dir = 1; icon_state = "outerturn"},/area/f13/wasteland)
"dk" = (/turf/open/indestructible/ground/sidewalk{dir = 1; icon_state = "outerbordercorner"},/area/f13/wasteland)
"dl" = (/obj/structure/chair/comfy/black,/turf/open/floor/f13{icon_state = "floorrusty"},/area/f13/secret)
"dm" = (/turf/open/indestructible/ground/road{icon_state = "verticalleftborderright1"},/area/f13/wasteland)
"dn" = (/obj/effect/decal/marking{tag = "icon-dottedverticalcorroded"; icon_state = "dottedverticalcorroded"},/turf/open/indestructible/ground/road,/area/f13/wasteland)
"do" = (/turf/open/indestructible/ground/road{icon_state = "verticalinnermain2top"},/area/f13/wasteland)
"dp" = (/obj/structure/chair/comfy/black{dir = 4},/turf/open/floor/f13{icon_state = "floorrusty"},/area/f13/secret)
"dq" = (/obj/structure/table,/obj/item/weapon/reagent_containers/food/drinks/drinkingglass/shotglass,/turf/open/floor/f13{icon_state = "floordirty"},/area/f13/secret)
"dr" = (/obj/structure/table,/obj/item/weapon/reagent_containers/food/drinks/bottle/whiskey{pixel_x = -15; pixel_y = -10},/turf/open/floor/f13{icon_state = "floordirty"},/area/f13/secret)
"ds" = (/obj/structure/chair/comfy/black{dir = 8},/turf/open/floor/f13{icon_state = "floordirty"},/area/f13/secret)
"dt" = (/obj/structure/simple_door/brokenglass,/turf/open/floor/f13{icon_state = "floorrusty"},/area/f13/secret)
"du" = (/obj/effect/decal/marking{tag = "icon-dottedverticalcorroded"; icon_state = "dottedverticalcorroded"},/turf/open/indestructible/ground/road{icon_state = "verticalinnermain1"},/area/f13/wasteland)
"dv" = (/turf/open/indestructible/ground/road{icon_state = "verticalinnermain3"},/area/f13/wasteland)
"dw" = (/turf/closed/wall/f13/supermart{desc = "Remove kebab."; icon_state = "storeprewindowvertical"; name = "kebab outpost wall"},/area/f13/secret)
"dx" = (/obj/structure/table,/obj/item/weapon/coin/silver,/turf/open/floor/f13{icon_state = "floorrusty"},/area/f13/secret)
"dy" = (/obj/structure/table,/obj/item/weapon/reagent_containers/food/drinks/drinkingglass/shotglass{pixel_y = 5},/turf/open/floor/f13{icon_state = "floorrusty"},/area/f13/secret)
"dz" = (/obj/structure/chair/comfy/black{dir = 8},/turf/open/floor/f13{icon_state = "floorrusty"},/area/f13/secret)
"dA" = (/obj/structure/chair/wood/modern{dir = 4},/turf/open/floor/f13{icon_state = "floordirty"},/area/f13/secret)
"dB" = (/obj/structure/table,/obj/item/weapon/reagent_containers/food/snacks/f13/mre,/turf/open/floor/f13{icon_state = "floordirty"},/area/f13/secret)
"dC" = (/obj/item/weapon/gun/ballistic/revolver/magnum{pixel_y = -5},/obj/structure/bed,/obj/item/weapon/bedsheet/patriot,/turf/open/floor/f13{icon_state = "floorrusty"},/area/f13/secret)
"dD" = (/obj/effect/decal/marking,/turf/open/indestructible/ground/road,/area/f13/wasteland)
"dE" = (/obj/structure/chair/comfy/black{dir = 1},/turf/open/floor/f13{icon_state = "floorrusty"},/area/f13/secret)
"dF" = (/obj/structure/table,/obj/structure/bedsheetbin,/turf/open/floor/f13{icon_state = "bluerustychess"},/area/f13/secret)
"dG" = (/obj/structure/mirror{pixel_y = 29},/obj/structure/sink{pixel_y = 20},/turf/open/floor/f13{icon_state = "bluedirtychess"},/area/f13/secret)
"dH" = (/obj/structure/table,/obj/item/weapon/lipstick,/turf/open/floor/f13{icon_state = "bluedirtychess"},/area/f13/secret)
"dI" = (/obj/structure/table,/obj/item/weapon/folder/yellow/secret,/turf/open/floor/f13{icon_state = "floorrusty"},/area/f13/secret)
"dJ" = (/obj/structure/table,/obj/item/weapon/paper{pixel_x = -4; pixel_y = -4},/obj/item/weapon/paper{pixel_y = 4},/obj/item/weapon/paper{pixel_x = 9},/obj/item/weapon/pen/blue,/turf/open/floor/f13{icon_state = "floorrusty"},/area/f13/secret)
"dK" = (/obj/structure/table,/obj/item/weapon/paper/nuke_instructions,/turf/open/floor/f13{icon_state = "floorrusty"},/area/f13/secret)
"dL" = (/obj/structure/simple_door/room,/turf/open/floor/f13{icon_state = "bluedirtychess"},/area/f13/secret)
"dM" = (/turf/open/floor/f13{icon_state = "bluedirtychess"},/area/f13/secret)
"dN" = (/obj/structure/chair/stool/blue,/turf/open/floor/f13{icon_state = "bluerustychess2"},/area/f13/secret)
"dO" = (/obj/structure/filingcabinet/filingcabinet,/turf/open/floor/f13{icon_state = "floordirty"},/area/f13/secret)
"dP" = (/obj/structure/chair/office/blue{dir = 1},/turf/open/floor/f13{icon_state = "floorrusty"},/area/f13/secret)
"dQ" = (/obj/machinery/light,/turf/open/floor/f13{icon_state = "floorrusty"},/area/f13/secret)
"dR" = (/obj/machinery/light/small,/turf/open/floor/f13{icon_state = "bluerustychess"},/area/f13/secret)
"dS" = (/obj/structure/toilet{dir = 8},/turf/open/floor/f13{icon_state = "bluedirtychess"},/area/f13/secret)
"dT" = (/turf/open/indestructible/ground/road{icon_state = "verticalleftborderright2"},/area/f13/wasteland)
"dU" = (/turf/open/indestructible/ground/sidewalk{dir = 4; icon_state = "outercornermisc"},/area/f13/wasteland)
"dV" = (/turf/open/indestructible/ground/sidewalk{icon_state = "verticalleftborderleftbottom"},/area/f13/wasteland)
"dW" = (/turf/open/indestructible/ground/road{icon_state = "verticalleftborderrightbottom"},/area/f13/wasteland)
"dX" = (/turf/open/indestructible/ground/road{icon_state = "verticalrightborderleftbottom"},/area/f13/wasteland)
"dY" = (/turf/open/indestructible/ground/sidewalk{icon_state = "verticalrightborderrightbottom"},/area/f13/wasteland)
"dZ" = (/turf/open/indestructible/ground/sidewalk{dir = 1; icon_state = "outercornermisc"},/area/f13/wasteland)

(1,1,1) = {"
aaaaaaaaaaaaaaababaaacadaaaeafaaaaaaaaaaaaaaaaaaaaaaaaaaaaaa
aaagaaahacaaababaiabacajaaakalahamamamamamamamamamamamamamad
aaahamanaoababababapaoaqamadaaarasatauavavavawaxasasasasasaj
aaarayayayayayazayayayayayajaaaraAaBaCaCaCaCaCaDasaEaFaGasaj
aaarayaHaIaJaKaKaLaMaKaNayajaaaraOaCaCaPaCaQaPaPaRaSaSaTasaj
aaarayaKaKaKaKaKaKaKaKaKayajaaaraUaCaVaWaVaXaCaPasaYaSaZasaj
aaaraybaaKaKbbaKaKbcaIbdayajaaarbeaCbfbgbfbfaCaCasasasasasaj
aaarayaIbhaKaKaKaKbcbibdayajaaarbjbkaCaCaPaPaCblasbmbmbnasaj
aaarayaKaKboaKaKaKboaKaKaybpbqbrasbsbtaCaCbuaPaCbvaPaCbwasaj
aaarayaybxayaybyayaybzayayajaaarasbAbAaPaCaCaCaCasaCbBbCasaj
aabDbEbEbEbEbFbGbHbEbEbEbEbIaaarasbJbKaPaPaCaCbLasaCaPbMasaj
aaaaaaaaaaaaarbGajaaaaaaaaaaaaarasbNbNaCaPaCaCbOasbPbQbRasaj
ahamamamamamanbGaqamamamadagaaarasasasasasbSasasasasasasasaj
arbGbTbUbVbWbXbYbZbZcabGajaaaaarbGcbascccdcececfcecececgasch
arcicjckclclckcmcnckcocpaqamamanbGbGascecececececqcrceceasaj
arcsctctctcucuctctctctcvbGbGbGbGbGbGcwcecececececxcycececwaj
arcsczcAcucucucucBcAcCcvbHbEbEbFbGbGascecececececqcqcecDasaj
arcEcFcucGcHcIcGcucAcJcKajaaaaarbGcbascLcecececMcecececNasch
arcEcFcHcOcPcQcIcAcAcJcKcRaaaaarasasasasasbSasasasasasasasaj
arcEcFcScTaaaacUcAcAcJcvajaaaaaraAcVcWcXcYaPaPcZasdadbdcasaj
arcscFcAcScTdddecucAdfcvajaaaaaraOaCaCaPaCaPaCdgasaCaCbMasaj
ardhdicAcAcSdecucAcAdjdkajaaaaaraUaPaPdldlaCaCaPasaPaCaPasaj
bDbFcEdmcAcAdndocAcJcvbHbIaaaaaraUaPdpdqdrdsaCaCdtaCaCbwasaj
aaarcEdmcucAdudvcGdfcKajaaagaaardwaPdpdxdydzaCaPasdAdBdCasaj
aaarcEdmcAcAdDcGcucJcKajaaaaaaaraUaPaCdEdEaCaPblasasasasasaj
aaarcscFcBcAdncAcAcJcvajaaaaaaaraUaPaPaCaPaCaCaCasdFdGdHasaj
aaarcscFcAcAdncucAcJcvajaaaaaaarbedIdJdKaCaPaCaPdLdMdMdNasaj
aaarcEcFcAcucucucucJcvajaaaaaaarbjdOdPdQaCdQaPaCasdMdRdSasaj
aaarcsdTcGcHcOcIcGdfcKajaaaaaaarasasasasasasasasasasasasasaj
aadUdVdWcOcPaacQcOdXdYdZaaaaaabDbEbEbEbEbEbEbEbEbEbEbEbEbEbI
"}
